000000000000000
0an111111111nn0
0n01010101010n0
011111111111110
010101010101010
011111111111110
010101010101010
011111111111110
010101010101010
011111111111110
010101010101010
011111111111110
0n01010101010n0
0nn111111111nx0
000000000000000